@Objects
e r
o 
d d
@Map
oooooooooooooooooooo
o..................o
o..eeeeee..........o
o..oo..oo..........o
o..eeeeee..........o
o..................o
o..................o
o..................o
o..................o
o..................o
d..................o
o..................o
o..................o
o..................o
ooooooooooodoooooooo