@Objects
e r
o 
d d
@Map
oooooooooooooooooooo
o..................o
o..................o
o..................o
o..............e...o
o..................o
o..................d
o..................o
o.ooooo.oooo.oooo..o
o...o...o....o.....o
o...o...oooo.oooo..o
o...o...o.......o..o
o...o...oooo.oooo..o
o..................o
ooooooooodoooooooooo