@Objects
p u
e r
o 
d d
@Map
ooooooooodoooooooooo
o.p............o.o.o
o...............e..o
o..............o.o.o
o..................o
o..................o
o..................o
o.o..o..o..........o
o.o..o..o...e......o
o.o..o..o..........o
o.o..o..o..........o
o.o.....o..........o
o.ooooooo...e......o
o..................o
oooooooooooooooooooo