@Objects
p u
e r
o 
@Map
oooooooooooooooooooo
o.p............o.o.o
o..................o
o..............o.o.o
o..................o
o..................o
o..................o
o.o..o..o..........o
o.o..o..o...e......o
o.o..o..o..........o
o.o..o..o..........o
o.o.....o..........o
o.ooooooo...e......o
o..................o
oooooooooooooooooooo