@Objects
p u
o
@Map
oooooooooooooooooooo
o.p............o.o.o
o..................o
o..............o.o.o
o..................o
o..................o
o..................o
o.o..o..ooooooo....o
o.o..o..o.....o....o
o.o..o..o..o..o....o
o.o..o..o..o..o....o
o.o.....o..o..o....o
o.ooooooo..o..o....o
o..................o
oooooooooooooooooooo